A Hero's Death (Radio Mix)	Fontaines D
	
Clean Kill	Coriky
	
Mr	Motivator
	
The Truth	I LIKE TRAINS
	
Dressing America	Torres
	
	
	
People Keep Dying (And No One Can Stop It)	Hallelujah The Hills
	
Martin	Car Seat Headrest
	
Starstruck	Sorry
	
People Don't Protest Enough	Catholic Action
	
Goodbye Year, Goodbye	X
	
	
	
Televised Mind	Fontaines D
	
Here's the Thing	Sports Team
	
Quit Fucking Around	Francis of Delirium
	
Not A Runner	Momma
	
I Think You're Great	Alex the Astronaut
	
	
	
Something I Should Do	Nada Surf
	
Haircut Sphinx	Guided By Voices
	
No Puedo Pensar	Melenas
	
Sliver	Kim Gordon
	
Revising My Fee	Mush
	
	
	
Dig In	I LIKE TRAINS
	
Alexandra	RVG
	
Forgot My Horse's Name	Tenci
	
All My Friends	The No
	
Clutter & Mess	Green Buzzard
	
	
	
In / Out	En Attendant Ana
	
Monkey Crazy	The Coffin Daggers
	
Running Hot With Fate	Hallelujah The Hills
	
Inauguration Day	Coriky
	
Sludge (radio edit)	Squid
	
	
	
Fixer Upper	Yard Act
	
White Noise White Heat	Elbow
	
Future Peg	Man Man
	
Born Confused	Porridge Radio
	
Polyaneurism	of Montreal
	
	
	
Turned To String	No Age
	
Lemon Tea	Galore
	
Pantomima	Greg Dulli
	
I Was Not Born	Fontaines D
	
Waves	Hum
	
	
	
No Scene	Dope Body
	
Roll With Me	Bell Towers
	
(Don't Break My) Devotion	Jade Hairpins
	
Existential Dread	Mush
	
Hot Slick	PINS
	
	
	
Stations of the Cross	Sports Team
	
Where to Start	Bully
	
Dream Cleaver	Death Valley Girls
	
Nothing At All	Perfume Genius
	
Home (Radio Edit)	Caribou