Wet Leg	Chaise Longue
Amigo The Devil	Murder at the Bingo Hall
Parquet Courts	Walking At A Downtown Pace
Glume	Get Low
Dry Cleaning	Scratchcard Lanyard
Sleaford Mods	Elocution
Goat Girl	Badibaba
Surfbort	Never Nude
Mandy, Indiana	Bottle Episode
Amyl and The Sniffers	Guided By Angels
Viagra Boys	Girls & Boys (Tedit)
Liars	Sekwar
Yard Act	The Overload
Whispering Sons	Satantango
Bnny	Time Walk
Erica Nockalls	I Know (feat
Squid	G
IDLES	Meds
Dutch Tulips	Tell Me Your Codes
Holiday Ghosts	Total Crisis
Juliana Hatfield	Nightmary
Ty Segall	Feel Good
Dry Cleaning	Her Hippo
Francis of Delirium	Red
Women Of The Night	Open All Night
Dinosaur Jr	
Guided by Voices	Trust Them Now
The Irrational Library	We
Iceage	Dear Saint Cecilia
CLAMM	Keystone Pols
Art d'Ecco	Head Rush
The Goon Sax	In the Stone
Parquet Courts	Marathon Of Anger
Gruff Rhys	Hiking In Lightning
King Ropes	Big Man on the TV
The Murlocs	Francesca
LUMIERE	AMITIE DECHUE
Jose Gonzalez	Valle Local
Kiwi Jr	
Pip Blom	Keep It Together
Tristen	Athena
Wet Leg	Wet Dream
Alaska Reid	Boys From Town
Erica Nockalls	The King of Want
Snail Mail	Ben Franklin
Shannon And The Clams	Mary Don't Go
Cheekface	We Need a Bigger Dumpster
Guided By Voices	My (Limited) Engagement
Alex Rex	What's Shouted In The Dark (The Dark Shouts Back)
IDLES	Crawl!