Boys In The Better Land (Radio Edit)	Fontaines D.C.
Magic Of Meghan	Dry Cleaning
Transition From Nowhere to Nowhere	Ezra Furman
Houseplants (radio edit)	Squid
Daddy Issues (Radio Edit)	Pip Blom
Satdeenight Ready	Ernest Moon
Je Ne Me Connais Pas	Mattiel
Liberty Belle	Fontaines D.C.
More Is Less	The Murder Capital
Running Hot With Fate	Hallelujah The Hills
Identity Theft	The Chats
Dog Proposal	Dry Cleaning
The Cleaner (radio edit)	Squid
Berlin Weekend	Mattiel
My Teeth Hurt	Ezra Furman
Boring	Our Girl
Mr. Polydactyl Cat	Levitation Room
Big	Fontaines D.C.
Got You	Amyl and The Sniffers
Calling It	Automatic
Season's Greetings	Stella Donnelly
All the Same	Queen of Jeans
Don't Make It Difficult	Pip Blom
Cammie at Night	Goon
People's Faces (radio edit)	Kate Tempest
Midwest Hotel	Mattiel
Capitalism	Ernest Moon
Window	Lunch Lady
Taste	Ty Segall
New Comedown (Radio Edit)	Plague Vendor
Isolation Line	1000 Lights
Leslie	Kiwi Jr.
Match Bet	Squid
It's So Weird	Juliana Hatfield
M5	Sports Team
Hey Buddy	The Coathangers
Twitch	Miss June
Pink Lemonade	Daddy Long Legs
Lung of the City	Possible Humans
What's On Your Mind	Martin Frawley
Old Man	Stella Donnelly
You Were Right	Julia Jacklin
Naive Castle (tedit)	Wildhoney
You've Got Fire	Oh, Rose
Destroyer	TR/ST
Snickersnee	Thee Oh Sees
ABC's in Old Berlin	L.T.D.
Nekrodisco	Prettiest Eyes
The Dial (radio edit)	Squid
Hank Williams	Pottery