Flag of Alsace	Alsace	Alsace	Alsatian: Elsàss
German: Elsass	Strasbourg	42	Formerly a coalition of free cities in Holy Roman Empire, attached to Kingdom of France in 1648.
Annexed by Germany from Franco-Prussian war to the end of World War I and briefly during World War II
Philippe Richert (UMP)
Flag of Aquitaine	Aquitaine	Aquitaine	Occitan: Aquitània
Basque: Akitania
Saintongeais : Aguiéne	Bordeaux	72	Guyenne and Gascony	Alain Rousset (PS)
Flag of Auvergne	Auvergne	Auvergne	Occitan: Auvèrnhe / Auvèrnha	Clermont-Ferrand	83	Former province of Auvergne	René Souchon (PS)
Flag of Brittany	Brittany	Bretagne	Breton: Breizh
Gallo: Bertaèyn	Rennes	53	Duchy of Brittany	Jean-Yves Le Drian (PS)
Flag of Burgundy	Burgundy	Bourgogne	Burgundian: Bregogne / Borgoégne
Franco-Provençal: Borgogne	Dijon	26	Duchy of Burgundy	François Patriat (PS)
Flag of Centre	Centre	Centre		Orléans	24	Located in north-central France (central part of the original French language area)	François Bonneau (PS)
Flag of Champagne-Ardenne	Champagne-Ardenne	Champagne-Ardenne		Châlons-en-
Champagne	21	Former province of Champagne	Jean-Paul Bachy (PS)
Flag of Franche-Comté	Franche-Comté	Franche-Comté	Franc-Comtois: Fràntche-Comté
Franco-Provençal: Franche-Comtât	Besançon	43	Free County of Burgundy
(Franche-Comté)	Marie-Marguerite Dufay (PS)
Flag of Île-de-France	Île-de-France	Île-de-France		Paris	11	Province of Ile-de-France and parts
of the former province of Champagne	Jean-Paul Huchon (PS)
Flag of Languedoc-Roussillon	Languedoc-Roussillon	Languedoc-Roussillon	Occitan: Lengadòc-Rosselhon
Catalan: Llenguadoc-Rosselló	Montpellier	91	Former provinces of Languedoc
and Roussillon	Christian Bourquin (DVG)
Flag of Limousin	Limousin	Limousin	Occitan: Lemosin	Limoges	74	Former province of Limousin and parts
of Marche, Berry, Auvergne, Poitou
and Angoumois	Jean-Paul Denanot (PS)
Flag of Lorraine	Lorraine	Lorraine	German: Lothringen
Lorraine Franconian: Lottringe	Metz	41	Named for Charlemagne's son Lothair I, the kingdom of Lotharingia is etymologically
the source for the name Lorraine (duchy), Lothringen (German), Lottringe (Lorraine Franconian)	Jean-Pierre Masseret (PS)
Flag of Lower Normandy	Lower Normandy	Basse-Normandie	Norman: Basse-Normaundie	Caen	25	Western half of former province of Normandy	Laurent Beauvais (PS)
Flag of Midi-Pyrénées	Midi-Pyrénées	Midi-Pyrénées	Occitan: Miègjorn-Pirenèus
Occitan: Mieidia-Pirenèus	Toulouse	73	None; created for Toulouse	Martin Malvy (PS)
Flag of Nord-Pas-de-Calais	Nord-Pas-de-Calais	Nord-Pas-de-Calais	Dutch: Noord-Nauw van Kales	Lille	31	Nord and Pas-de-Calais departments	Daniel Percheron (PS)
Flag of Pays-de-la-Loire	Pays de la Loire	Pays de la Loire	Breton: Broioù al Liger	Nantes	52	None; created for Nantes	Jacques Auxiette (PS)
Flag of Picardie (Picardy)	Picardy	Picardie		Amiens	22	Former province of Picardy	Claude Gewerc (PS)
Flag of Poitou-Charentes	Poitou-Charentes	Poitou-Charentes	Occitan: Peitau-Charantas
Poitevin and Saintongeais : Poetou-Chérentes	Poitiers	54	Former provinces of Angoumois, Aunis, Poitou and Saintonge	Ségolène Royal (PS)
Flag of Provence-Alpes-Côte d'Azur	Provence-Alpes-Côte d'Azur (PACA)	Provence-Alpes-Côte d'Azur (PACA)	Occitan:
   Provença-Aups-Còsta d'Azur
   Prouvènço-Aup-Costo d'Azur	Marseille	93	Provence plus the former county of
Nice, principality of Orange and Comtat Venaissin	Michel Vauzelle (PS)
Flag of Rhône-Alpes	Rhône-Alpes	Rhône-Alpes	Franco-Provençal: Rôno-Arpes
Occitan: Ròse Aups	Lyon	82	Created for Lyon from Dauphiné and
Lyonnais provinces
and Savoy	Jean-Jack Queyranne
Flag of Haute-Normandie	Upper Normandy	Haute-Normandie	Norman: Hâote-Normaundie	Rouen	23	Eastern half of former province of Normandy